█████████████
█ P ó ░   P █
█   █ ░ █ ó █
█ ░ ░ ░ ░ ░ █
█ ó █ ░ █   █
█ P   ░ ó P █
█████████████